###############
#S......#.....#
#.#####.#.###.#
#...#...#...#.#
#.#.#.#######.#
#.#.#.....#...#
#.#.#####.#.###
#.#.....#.#...#
#.###.###.###.#
#.............E