############
#S#.#.......
#.#.#.######
#...........
###.#######.
#...#.#...#.
###.#.#.###.
#.........#E