############################################################
#S..#.#.......#...#.........#...........#.......#.....#.....
###.#.#.###.#.#.#.#.#####.#.###.#######.#####.#.###.#.###.#.
#.#.#...#...#.#.#...#.....#...#.#.....#.#.....#.....#.....#.
#.#.#####.###.#######.#######.#.###.###.#.#################.
#...#.....#.#.........#.....#.#...#...#.#.........#.#.......
#.###.#####.###########.###.#.###.###.#.#####.###.#.#.######
#.#...#...........#.#...#...#...#...#.......#...#.#.#.#.....
#.#.###.#######.#.#.#.#.#######.#.#.#######.#.###.#.#.#.###.
#...#...#...#...#.#...#.....#...#.#...#.....#.#...#.#.#.#.#.
#####.###.#.#.###.#########.#.###.###.###.###.#.###.#.#.#.#.
#.#...#...#...#.............#...#...#...#.#...#.#.....#...#.
#.#.###.###################.###.###.###.#.#####.#######.###.
#.#...#...#.........#...#.....#...#.#.#.#.....#.......#.#...
#.###.###.#.#######.#.#.#########.#.#.#.#####.#.#####.#.#.#.
#.#.....#.#.#.....#...#.#.......#.#...#.#...#.#.#...#...#.#.
#.#.#####.#.#.###.#####.#.#####.#.###.#.#.###.#.#.#.#####.#.
#...#...#.#.#.#.....#.#.#...#...#.#...#.#.#...#.#.#.#.....#.
#.###.#.#.#.###.###.#.#.###.#.###.###.#.#.#.###.#.###.#####.
#.#...#.#.#...#.#...#.#.....#...#...#.#.#.....#.#.#...#.....
###.###.#.###.#.#.###.#########.###.###.#####.#.#.#.#######.
#...#.#.#...#.#.#.......#.......#.#...#...#...#...#.......#.
#.###.#.#.###.#.#######.#.#####.#.###.#.#.#.#######.#####.#.
#.#.#.....#...#.#.....#.#.#.#...#...#.#.#.#.......#.....#.#.
#.#.#.#####.###.#.###.#.#.#.#.###.#.#.###.#######.###.###.#.
#.#...#.....#...#.#.#...#.#...#.#.#.#...#.#.....#.#...#...#.
#.#####.#######.#.#.#####.###.#.#.#.###.#.#.#####.#.###.####
#.#.....#.......#.......#...#.#...#...#.#.#.......#...#.....
#.#.#####.###.#########.###.#.#.#####.#.#.#.#############.#.
#.#.....#...#.......#.#.#.#.#.#.#.....#...#.#.......#...#.#.
#.#####.#.#######.#.#.#.#.#.#.###.###.#####.#####.#.#.#.###.
#.....#.#.#.....#.#.#.....#.#.....#...#...#.......#.#.#...#.
#.###.#.#.#.###.###.#####.#.#######.###.#.#########.#.###.#.
#.#...#.#.#...#...#...#...#.......#.....#.#.......#.#...#.#.
#.#.###.#.###.###.###.#.#########.#######.#######.#.###.#.#.
#.#.#...#.#...#.....#.#.......#...#.....#...#.....#.#...#...
#.#.#.#####.#######.#.#####.###.#.#.###.###.#.###.#.#.#####.
#.#...#...#.....#...#...#.#.#...#.#...#.#.....#...#.#.#.....
#.#####.#.#####.#.#####.#.#.#.#######.#.###########.#.#.####
#.......#.......#.......#...#.........#...............#....E