######################################################################
#S#...#...........#...#.......#...#.........#...............#.....#...
#.#.#.###.#######.#.#.#.#####.#.#.#.#######.#.#########.###.###.#.###.
#...#.....#.....#.#.#...#.......#.#.#.#...#.#.....#...#...#.....#.....
###########.###.#.#.#####.#########.#.#.#.#.###.###.#.#.#.###########.
#.........#.#.#...#.....#...#.....#.#.#.#...#...#...#.#.#.......#.....
#.#####.###.#.#####.###.#.###.###.#.#.#.###.#.###.###.#.#######.######
#.#...#...#.#.....#.#...#.#.....#.#.#.#...#.#...#...#.#.#.....#.#.....
#.#.#.###.#.#.###.#.#.#####.#####.#.#.###.#####.###.#.#.#.###.#.#.###.
#.#.#.....#.#...#.#.#.......#...#...#...#.#...#.#...#.#.#.#.....#...#.
#.#.#####.#.###.#.###########.#.#.#####.#.#.#.#.#.###.###.#.#######.#.
#.#.#.....#.#...#...........#.#.#.......#...#...#.#...#...#.#.#.....#.
#.#.#####.#.#.#############.#.#.#.#####.#########.#.###.###.#.#.#####.
#.#.....#.#.#...........#.#.#.#.#.#...#...#.......#.#...#.#.#.#.#.....
#.#####.###.###########.#.#.#.#.###.#.###.#.#######.#.###.#.#.#.#.###.
#.#...#...#.............#...#.#.....#.#...#.#.#.....#.#...#...#.#.#...
#.#.#.###.###############.###.#######.#####.#.#.#####.#.#.#.###.#.####
#.#.#...#.......#...#...#.....#.......#...#.#.....#...#.#...#...#.....
#.#.#.#####.###.#.#.###.#######.#######.#.#.#####.###.#.#####.#######.
#.#.#.#...#...#.#.#.....#.......#.....#.#.#.....#.....#.....#...#.#...
#.#.#.#.#.###.#.#.#.#####.#######.###.#.#.#####.#.#######.#####.#.#.##
#.#.#.#.#.#...#.#.#.#.....#.......#.#...#.....#.#.#...#...#...#.#.#...
#.#.###.#.#.###.#.#.#.#######.#####.#########.#.#.#.#.###.#.#.#.#.###.
#.#.....#.#...#...#.#...#.....#...#.........#.#.#.#.#...#.#.#.......#.
#.#######.###.#########.#.#####.###.#####.###.#.###.###.###.#########.
#.........#.#.#.........#.#.......#.#...#.#...#.....#.#.....#...#...#.
#########.#.#.#.#########.#.#####.#.###.#.#.#####.###.#######.#.#.#.#.
#...#...#...#...#.........#...#.#...#...#.#.....#...........#.#.#.#...
#.#.#.#.###.#########.#######.#.#####.###.#####.###########.#.#.#.###.
#.#...#...#.#.........#.....#.#.....#...#.....#.#.....#...#.#.#...#...
#.#######.#.#####.#######.#.#.#.###.###.#####.#.#.###.#.###.#.#######.
#...#...#...#.....#.......#.#.#.#...........#...#...#.#...#.#.......#.
###.#.#.#####.#####.#########.#.###########.#######.#.###.#.#######.##
#...#.#.#.....#...#.....#.....#...#.....#.#...#.....#...#...#.....#...
#.###.#.#.#.###.#.#.###.#.#####.#.#.###.#.###.###.#####.###.###.#####.
#.#...#...#.#...#.#.#.#...#.....#.#.#.....#.#.....#...#...#.....#.....
#.###.#####.#.#####.#.#####.#####.#.#####.#.#######.#.###.#####.#.###.
#...#.#...#.#.......#...#...#...#.#.....#.......#...#.#...#...#.#.#.#.
###.###.#.#.#.#######.#.#####.#.#.#.###.#########.#.###.###.#.###.#.#.
#.......#...#.........#.......#...#...#...........#.........#.....#..E