##############################
#S#.#.........................
#.#.#.#.#####.#.#.#.###.#.#.##
#.....#.....#.#.#.#...#.#.#...
#.###.###.###.#######.###.#.##
#...#...#...#.......#...#.#...
#.###.#######.###.#######.####
#.#.........#...#...#.#...#.#.
#.#.###.#.#.#.#.###.#.#####.#.
#.#.#...#.#.#.#...#...........
###.###.###.###.###.#.###.###.
#.....#.#.#...#...#.#...#.#...
###.#.#.#.#.#.#.#.#####.###.#.
#...#.#.#...#.#.#.#.......#.#.
#############################E